%%%%%%%%%%
%.  .P . %
%%%%%%%%%%
